,DistrictName,GraduationPercentageRate,DropoutPercentageRate,FundingPerStudent,TotalEnrolled,MalesEnrolled,FemalesEnrolled,WhiteStudentsEnrolled,Percentage of Minority Students
0,ADDISON CSD,90,3,23833.02,976,503,473,945,3.2
1,ADIRONDACK CSD,92,5,14013.61,1145,575,570,1125,1.7
2,AFTON CSD,83,10,24128.02,507,262,245,462,8.9
3,AKRON CSD,95,3,17552.56,1334,667,667,1101,17.5
4,ALBANY CITY SCHOOL DISTRICT,71,12,22382.65,8610,4444,4166,1708,80.2
5,ALBION CSD,85,11,15094.95,1781,887,894,1327,25.5
6,ALDEN CSD,96,1,16574.76,1581,783,798,1514,4.2
7,ALEXANDER CSD,95,2,19435.51,787,378,409,736,6.5
8,ALEXANDRIA CSD,88,5,21219.66,472,232,240,447,5.3
9,ALFRED-ALMOND CSD,100,0,18461.16,601,329,272,543,9.7
10,ALLEGANY-LIMESTONE CSD,87,4,16367.35,1103,574,529,1014,8.1
11,ALTMAR-PARISH-WILLIAMSTOWN CSD,82,9,23307.26,1067,537,530,999,6.4
12,AMAGANSETT UFSD,—,—,97583.80,64,30,34,39,39.1
13,AMHERST CSD,93,1,15755.19,2925,1516,1409,1956,33.1
14,AMITYVILLE UFSD,85,7,23455.51,2997,1594,1403,139,95.4
15,AMSTERDAM CITY SCHOOL DISTRICT,84,6,17207.22,3586,1838,1748,1458,59.3
16,ANDES CSD,100,0,38857.67,65,35,30,58,10.8
17,ANDOVER CSD,89,4,24277.59,278,127,151,270,2.9
18,ARDSLEY UFSD,97,0,25178.37,2325,1257,1068,1336,42.5
19,ARGYLE CSD,86,11,23262.18,463,233,230,438,5.4
20,ARKPORT CSD,100,0,19505.93,459,241,218,431,6.1
21,ARLINGTON CSD,91,3,21035.77,7963,3966,3997,5227,34.4
22,ATTICA CSD,91,2,20326.08,1160,574,586,1105,4.7
23,AUBURN CITY SCHOOL DISTRICT,76,12,15909.72,4106,2124,1982,3163,23.0
24,AUSABLE VALLEY CSD,88,11,23515.55,1112,561,551,1074,3.4
25,AVERILL PARK CSD,94,3,18170.81,2663,1336,1327,2432,8.7
26,AVOCA CSD,95,3,23182.35,421,216,205,392,6.9
27,AVON CSD,93,2,15986.52,1007,518,489,887,11.9
28,BABYLON UFSD,96,0,29037.85,1555,787,768,1179,24.2
29,BAINBRIDGE-GUILFORD CSD,96,0,18604.94,773,394,379,699,9.6
30,BALDWIN UFSD,95,0,24058.03,4477,2360,2117,540,87.9
31,BALDWINSVILLE CSD,93,4,16551.37,5390,2816,2574,4720,12.4
32,BALLSTON SPA CSD,89,6,17822.98,4064,2105,1959,3725,8.3
33,BARKER CSD,92,2,20097.18,699,365,334,612,12.4
34,BATAVIA CITY SCHOOL DISTRICT,94,2,19357.91,2190,1156,1034,1580,27.9
35,BATH CSD,90,6,14747.30,1419,722,697,1362,4.0
36,BAY SHORE UFSD,87,4,23456.92,5848,2990,2858,1626,72.2
37,BAYPORT-BLUE POINT UFSD,98,0,30894.87,2080,1047,1033,1768,15.0
38,BEACON CITY SCHOOL DISTRICT,88,6,20683.23,2723,1358,1365,1217,55.3
39,BEAVER RIVER CSD,91,1,15124.46,871,456,415,848,2.6
40,BEDFORD CSD,86,4,29882.43,3902,1993,1909,2014,48.4
41,BEEKMANTOWN CSD,94,3,15225.58,1915,997,918,1809,5.5
42,BELFAST CSD,81,0,22753.52,322,167,155,309,4.0
43,BELLEVILLE-HENDERSON CSD,92,0,16968.41,463,240,223,424,8.4
44,BELLMORE UFSD,—,—,28180.70,946,475,471,727,23.2
45,BELLMORE-MERRICK CENTRAL HS DISTRICT,97,0,25413.48,5272,2672,2600,4126,21.7
46,BEMUS POINT CSD,98,2,17784.12,621,331,290,598,3.7
47,BERKSHIRE UFSD,—,—,N/A,83,72,11,32,61.4
48,BERLIN CSD,82,13,24974.93,673,349,324,649,3.6
49,BERNE-KNOX-WESTERLO CSD,92,1,24220.44,716,366,350,673,6.0
50,BETHLEHEM CSD,94,3,17185.56,4336,2205,2131,3644,16.0
51,BETHPAGE UFSD,95,1,26750.90,2945,1455,1490,1847,37.3
52,BINGHAMTON CITY SCHOOL DISTRICT,73,16,20117.55,4946,2535,2411,2062,58.3
53,BLIND BROOK-RYE UFSD,99,0,27396.38,1364,688,676,1060,22.3
54,BOLIVAR-RICHBURG CSD,94,5,21660.27,697,385,312,676,3.0
55,BOLTON CSD,86,0,38860.88,179,91,88,161,10.1
56,BOQUET VALLEY CSD,92,8,29438.51,410,220,190,400,2.4
57,BRADFORD CSD,97,3,25011.05,237,118,119,231,2.5
58,BRASHER FALLS CSD,86,8,18091.67,964,479,485,904,6.2
59,BRENTWOOD UFSD,76,12,19390.00,18826,9652,9174,552,97.1
60,BREWSTER CSD,88,6,26271.80,3066,1616,1450,1559,49.2
61,BRIARCLIFF MANOR UFSD,97,1,30106.31,1390,732,658,940,32.4
62,BRIDGEHAMPTON UFSD,86,7,60852.77,209,109,100,47,77.5
63,BRIGHTON CSD,95,1,18309.26,3518,1766,1752,2393,32.0
64,BROADALBIN-PERTH CSD,90,6,16438.42,1681,853,828,1595,5.1
65,BROCKPORT CSD,91,2,19153.63,3168,1625,1543,2520,20.5
66,BROCTON CSD,88,7,22092.47,509,231,278,417,18.1
68,BRONXVILLE UFSD,97,0,25738.45,1642,863,779,1316,19.9
69,BROOKFIELD CSD,82,14,24173.83,207,94,113,204,1.4
70,BROOKHAVEN-COMSEWOGUE UFSD,92,4,22056.41,3683,1813,1870,2145,41.8
72,BRUNSWICK CSD (BRITTONKILL),88,4,17579.17,1149,585,564,1028,10.5
73,BRUSHTON-MOIRA CSD,83,5,20707.52,761,400,361,740,2.8
74,BUFFALO CITY SCHOOL DISTRICT,76,12,18959.77,30674,15520,15154,5834,81.0
75,BURNT HILLS-BALLSTON LAKE CSD,96,2,17703.00,3082,1562,1520,2839,7.9
76,BYRAM HILLS CSD,99,0,34560.05,2274,1159,1115,1885,17.1
77,BYRON-BERGEN CSD,98,1,21604.84,828,385,443,733,11.5
78,CAIRO-DURHAM CSD,92,5,21073.84,1179,601,578,959,18.7
79,CALEDONIA-MUMFORD CSD,97,1,18494.78,755,367,388,704,6.8
80,CAMBRIDGE CSD,93,6,20247.70,823,420,403,759,7.8
81,CAMDEN CSD,86,6,19020.69,1963,983,980,1843,6.1
82,CAMPBELL-SAVONA CSD,95,3,20618.32,791,373,418,748,5.4
83,CANAJOHARIE CSD,94,4,21495.74,818,416,402,767,6.2
84,CANANDAIGUA CITY SCHOOL DISTRICT,92,4,17678.85,3357,1720,1637,2929,12.7
85,CANASERAGA CSD,71,18,24196.83,199,94,105,188,5.5
86,CANASTOTA CSD,84,7,17657.10,1275,645,630,1147,10.0
87,CANDOR CSD,93,3,19391.18,718,354,364,666,7.2
88,CANISTEO-GREENWOOD CSD,93,4,22874.26,935,495,440,895,4.3
89,CANTON CSD,82,1,20152.15,1171,610,561,1085,7.3
90,CARLE PLACE UFSD,98,0,32591.09,1358,712,646,877,35.4
91,CARMEL CSD,92,3,27298.65,3979,2034,1945,2483,37.6
92,CARTHAGE CSD,89,5,17149.15,3065,1602,1463,2271,25.9
93,CASSADAGA VALLEY CSD,88,7,20862.54,799,422,377,751,6.0
94,CATO-MERIDIAN CSD,89,5,18088.09,860,449,411,790,8.1
95,CATSKILL CSD,91,4,24088.35,1350,668,682,906,32.9
96,CATTARAUGUS-LITTLE VALLEY CSD,93,4,19362.54,858,431,427,799,6.9
97,CAZENOVIA CSD,94,2,17708.25,1360,727,633,1279,6.0
98,CENTER MORICHES UFSD,93,1,24593.36,1513,788,725,1107,26.8
99,CENTRAL ISLIP UFSD,88,1,21656.92,7571,3929,3642,299,96.1
100,CENTRAL SQUARE CSD,87,8,17310.54,3580,1827,1753,3363,6.1
101,CENTRAL VALLEY CSD AT ILION-MOHAWK,87,5,15522.11,2082,1025,1057,1887,9.4
102,CHAPPAQUA CSD,99,0,29069.23,3625,1870,1755,2685,25.9
103,CHARLOTTE VALLEY CSD,0,4,19819.35,382,202,180,354,7.3
104,CHATEAUGAY CSD,97,3,20495.72,451,243,208,445,1.3
105,CHATHAM CSD,94,4,25024.45,971,491,480,845,13.0
106,CHAUTAUQUA LAKE CSD,85,3,23416.94,706,328,378,670,5.1
107,CHAZY UFSD,94,6,19209.93,455,234,221,429,5.7
108,CHEEKTOWAGA CSD,87,7,16544.11,2138,1109,1029,846,60.4
109,CHEEKTOWAGA-MARYVALE UFSD,87,5,15434.40,2087,1081,1006,1506,27.8
110,CHEEKTOWAGA-SLOAN UFSD,86,5,19755.19,1232,641,591,942,23.5
111,CHENANGO FORKS CSD,93,0,18273.44,1340,727,613,1236,7.8
112,CHENANGO VALLEY CSD,91,5,18101.82,1648,841,807,1471,10.7
113,CHERRY VALLEY-SPRINGFIELD CSD,79,3,24150.04,422,219,203,413,2.1
114,CHESTER UFSD,90,1,24039.21,986,489,497,458,53.5
115,CHITTENANGO CSD,90,3,17253.94,1904,971,933,1745,8.4
116,CHURCHVILLE-CHILI CSD,91,2,15793.94,3751,1944,1807,2884,23.1
117,CINCINNATUS CSD,90,5,21748.43,514,239,275,502,2.3
118,CLARENCE CSD,95,2,15613.47,4228,2170,2058,3718,12.1
119,CLARKSTOWN CSD,95,1,22878.82,7821,4098,3723,4540,42.0
120,CLEVELAND HILL UFSD,85,6,18076.74,1254,634,620,597,52.4
121,CLIFTON-FINE CSD,77,0,28678.72,276,134,142,253,8.3
122,CLINTON CSD,96,1,17575.94,1258,649,609,1142,9.2
123,CLYDE-SAVANNAH CSD,78,17,21555.55,754,385,369,640,15.1
124,CLYMER CSD,93,0,21086.05,414,221,193,375,9.4
125,COBLESKILL-RICHMONDVILLE CSD,93,3,20054.26,1639,878,761,1475,10.0
126,COHOES CITY SCHOOL DISTRICT,84,11,17770.18,1873,943,930,1332,28.9
127,COLD SPRING HARBOR CSD,99,0,33287.48,1635,838,797,1408,13.9
128,COLTON-PIERREPONT CSD,94,0,22481.64,339,169,170,337,0.6
129,COMMACK UFSD,97,0,26170.47,5875,3018,2857,4508,23.3
130,CONNETQUOT CSD,95,2,28395.35,5509,2786,2723,4040,26.7
131,COOPERSTOWN CSD,99,1,19740.77,818,413,405,746,8.8
132,COPENHAGEN CSD,100,0,18762.25,393,212,181,363,7.6
133,COPIAGUE UFSD,89,7,18858.63,4965,2443,2522,609,87.7
134,CORINTH CSD,86,6,15265.53,1139,586,553,1084,4.8
135,CORNING CITY SCHOOL DISTRICT,88,6,19702.53,4551,2359,2192,3936,13.5
136,CORNWALL CSD,96,3,18883.36,3102,1632,1470,2001,35.5
137,CORTLAND CITY SCHOOL DISTRICT,80,7,18587.04,2132,1092,1040,1811,15.1
138,COXSACKIE-ATHENS CSD,82,7,20955.92,1242,679,563,1050,15.5
139,CROTON-HARMON UFSD,96,0,23468.52,1584,820,764,1130,28.7
140,CROWN POINT CSD,95,5,20638.87,286,135,151,284,0.7
141,CUBA-RUSHFORD CSD,92,0,19895.03,780,433,347,741,5.0
142,DALTON-NUNDA CSD (KESHEQUA),98,0,20242.29,589,297,292,574,2.5
143,DANSVILLE CSD,85,10,17846.30,1304,652,652,1217,6.7
144,DEER PARK UFSD,92,1,24053.21,3864,1984,1880,1405,63.6
145,DELAWARE ACADEMY CSD AT DELHI,90,0,20269.67,747,379,368,706,5.5
146,DEPEW UFSD,85,5,16749.58,1784,905,879,1518,14.9
147,DEPOSIT CSD,97,3,26448.82,458,242,216,440,3.9
148,DERUYTER CSD,88,6,24461.18,326,168,158,302,7.4
149,DOBBS FERRY UFSD,99,0,27547.73,1516,783,733,982,35.2
150,DOLGEVILLE CSD,87,9,17450.78,815,393,422,803,1.5
151,DOVER UFSD,84,6,20364.65,1351,691,660,834,38.3
152,DOWNSVILLE CSD,85,8,36396.35,207,98,109,191,7.7
153,DRYDEN CSD,68,14,22428.41,1364,699,665,1148,15.8
154,DUANESBURG CSD,98,2,18262.05,651,339,312,611,6.1
155,DUNDEE CSD,68,23,20317.42,621,330,291,568,8.5
156,DUNKIRK CITY SCHOOL DISTRICT,71,19,21073.97,1957,996,961,705,64.0
157,EAST AURORA UFSD,97,1,14972.77,1758,902,856,1659,5.6
158,EAST BLOOMFIELD CSD,94,2,19459.40,816,420,396,747,8.5
159,EAST GREENBUSH CSD,96,2,17840.81,4088,2049,2039,3225,21.1
160,EAST HAMPTON UFSD,83,9,32627.14,1712,852,860,640,62.6
161,EAST IRONDEQUOIT CSD,90,6,21188.16,2945,1488,1457,1307,55.6
162,EAST ISLIP UFSD,95,2,27025.08,3549,1855,1694,2584,27.2
163,EAST MEADOW UFSD,95,0,24954.87,7240,3643,3597,3499,51.7
164,EAST MORICHES UFSD,—,—,20972.97,684,335,349,555,18.9
165,EAST QUOGUE UFSD,—,—,30127.26,390,203,187,255,34.6
166,EAST RAMAPO CSD (SPRING VALLEY),65,20,20759.17,9387,4909,4478,319,96.6
167,EAST ROCHESTER UFSD,80,8,21751.23,957,488,469,696,27.3
168,EAST ROCKAWAY UFSD,96,1,27495.82,1173,576,597,702,40.2
169,EAST SYRACUSE MINOA CSD,90,1,20125.41,3138,1608,1530,2669,14.9
170,EAST WILLISTON UFSD,99,0,29899.60,1722,914,808,992,42.4
171,EASTCHESTER UFSD,99,0,23455.55,3232,1684,1548,2169,32.9
172,EASTPORT-SOUTH MANOR CSD,96,2,23188.70,3225,1646,1579,2788,13.6
173,EDEN CSD,88,3,17729.04,1307,669,638,1221,6.6
174,EDGEMONT UFSD,98,0,26154.46,2049,1061,988,927,54.8
175,EDINBURG COMMON SCHOOL DISTRICT,—,—,37016.86,53,26,27,51,3.8
176,EDMESTON CSD,91,3,21675.32,355,179,176,336,5.4
177,EDWARDS-KNOX CSD,83,5,20184.28,485,257,228,472,2.7
178,ELBA CSD,80,16,21297.72,374,194,180,297,20.6
179,ELDRED CSD,88,2,27604.29,464,224,240,397,14.4
181,ELLENVILLE CSD,81,11,26476.75,1516,751,765,700,53.8
182,ELLICOTTVILLE CSD,92,3,17000.21,568,295,273,520,8.5
183,ELMIRA CITY SCHOOL DISTRICT,73,16,18365.57,5544,2848,2696,3959,28.6
184,ELMIRA HEIGHTS CSD,88,6,17766.08,1018,503,515,888,12.8
185,ELMONT UFSD,—,—,21485.41,3324,1690,1634,163,95.1
186,ELMSFORD UFSD,89,1,28619.63,967,494,473,78,91.9
187,ELWOOD UFSD,98,1,25149.52,2049,1031,1018,1289,37.1
188,EVANS-BRANT CSD (LAKE SHORE),90,6,21444.49,2179,1124,1055,1683,22.8
189,FABIUS-POMPEY CSD,92,0,23378.61,611,302,309,577,5.6
190,FAIRPORT CSD,94,2,18288.31,5683,2932,2751,4836,14.9
191,FALCONER CSD,90,5,15754.62,1119,574,545,1052,6.0
192,FALLSBURG CSD,79,8,8070.27,1410,688,722,402,71.5
193,FARMINGDALE UFSD,95,3,26389.39,5521,2882,2639,3258,41.0
194,FAYETTEVILLE-MANLIUS CSD,96,0,17546.60,4203,2114,2089,3370,19.8
195,FILLMORE CSD,96,2,16259.19,639,320,319,612,4.2
196,FIRE ISLAND UFSD,—,—,117584.61,30,14,16,22,26.7
197,FISHERS ISLAND UFSD,90,0,53804.95,61,26,35,52,14.8
198,FLORAL PARK-BELLEROSE UFSD,—,—,17858.44,1472,750,722,857,41.8
199,FLORIDA UFSD,97,1,24475.23,789,399,390,478,39.4
200,FONDA-FULTONVILLE CSD,92,6,17693.40,1245,635,610,1157,7.1
201,FORESTVILLE CSD,90,4,19092.34,433,212,221,372,14.1
202,FORT ANN CSD,81,8,23523.79,421,244,177,392,6.9
203,FORT EDWARD UFSD,74,21,22672.08,444,224,220,405,8.8
204,FORT PLAIN CSD,86,2,20887.78,769,401,368,670,12.9
205,FRANKFORT-SCHUYLER CSD,90,1,17334.49,893,457,436,832,6.8
206,FRANKLIN CSD,100,0,24410.51,244,114,130,220,9.8
207,FRANKLIN SQUARE UFSD,—,—,16757.04,1832,953,879,1067,41.8
208,FRANKLINVILLE CSD,83,6,25123.20,594,293,301,547,7.9
209,FREDONIA CSD,96,2,17255.21,1418,730,688,1125,20.7
210,FREEPORT UFSD,86,2,21484.73,6765,3582,3183,373,94.5
211,FREWSBURG CSD,94,2,17462.27,777,378,399,730,6.0
212,FRIENDSHIP CSD,78,9,29150.45,304,153,151,276,9.2
213,FRONTIER CSD,91,3,14894.51,4612,2356,2256,4068,11.8
214,FULTON CITY SCHOOL DISTRICT,84,10,19719.91,3200,1659,1541,2871,10.3
215,GALWAY CSD,87,6,18867.04,800,392,408,791,1.1
216,GANANDA CSD,90,5,18478.74,893,440,453,757,15.2
217,GARDEN CITY UFSD,98,0,23500.03,3939,1964,1975,3310,16.0
218,GARRISON UFSD,—,—,36524.49,207,109,98,150,27.5
219,GATES CHILI CSD,86,4,19847.69,3698,1833,1865,2077,43.8
220,GENERAL BROWN CSD,93,4,13567.30,1388,711,677,1305,6.0
221,GENESEE VALLEY CSD,90,8,23997.00,478,243,235,454,5.0
222,GENESEO CSD,93,3,18482.09,855,444,411,705,17.5
223,GENEVA CITY SCHOOL DISTRICT,88,9,20180.79,1996,988,1008,856,57.1
224,GEORGE JUNIOR REPUBLIC UFSD,41,53,N/A,190,163,27,139,26.8
225,GERMANTOWN CSD,93,7,5403.88,485,263,222,417,14.0
226,GILBERTSVILLE-MOUNT UPTON CSD,92,3,23117.52,338,164,174,325,3.8
227,GILBOA-CONESVILLE CSD,100,0,26541.08,294,167,127,280,4.8
228,GLEN COVE CITY SCHOOL DISTRICT,87,4,22819.95,3163,1613,1550,776,75.5
229,GLENS FALLS CITY SCHOOL DISTRICT,84,8,17131.90,2022,1042,980,1730,14.4
230,GLENS FALLS COMMON SCHOOL DISTRICT,—,—,23169.56,157,72,85,126,19.7
231,GLOVERSVILLE CITY SCHOOL DISTRICT,68,17,18618.20,2554,1310,1244,2042,20.0
232,GORHAM-MIDDLESEX CSD (MARCUS WHITMAN,87,4,19833.28,1119,582,537,1083,3.2
233,GOSHEN CSD,96,0,22102.68,2885,1458,1427,2238,22.4
234,GOUVERNEUR CSD,84,9,18367.44,1461,739,722,1404,3.9
235,GOWANDA CSD,82,14,24073.62,1063,511,552,684,35.7
236,GRAND ISLAND CSD,95,2,17396.91,2869,1462,1407,2432,15.2
237,GRANVILLE CSD,79,11,18308.97,1020,545,475,966,5.3
238,GREAT NECK UFSD,93,2,28782.39,6586,3466,3120,2900,56.0
239,GREECE CSD,93,0,16901.72,10504,5322,5182,6083,42.1
240,GREEN ISLAND UFSD,86,11,23487.08,263,117,146,213,19.0
241,GREENBURGH CSD,93,0,34414.70,1581,803,778,191,87.9
242,GREENBURGH ELEVEN UFSD,22,33,N/A,71,71,0,3,95.8
243,GREENBURGH-GRAHAM UFSD,0,0,N/A,102,60,42,12,88.2
244,GREENBURGH-NORTH CASTLE UFSD,—,—,N/A,395,259,136,94,76.2
245,GREENE CSD,89,6,20546.04,924,479,445,875,5.3
246,GREENPORT UFSD,75,20,24403.49,660,351,309,180,72.7
247,GREENVILLE CSD,87,3,23538.21,1126,573,553,1077,4.4
248,GREENWICH CSD,91,1,18651.65,945,496,449,897,5.1
249,GREENWOOD LAKE UFSD,—,—,33865.79,474,236,238,307,35.2
250,GROTON CSD,90,3,19387.04,778,387,391,709,8.9
251,GUILDERLAND CSD,94,2,17693.96,4841,2451,2390,3556,26.5
252,HADLEY-LUZERNE CSD,89,7,25299.07,640,350,290,612,4.4
253,HALDANE CSD,93,3,25957.28,796,423,373,659,17.2
254,HALF HOLLOW HILLS CSD,95,1,27791.97,7676,3950,3726,4052,47.2
255,HAMBURG CSD,92,3,17076.46,3321,1649,1672,3088,7.0
256,HAMILTON CSD,90,5,20603.59,554,303,251,506,8.7
257,HAMMOND CSD,74,16,26123.36,242,124,118,239,1.2
258,HAMMONDSPORT CSD,76,11,27744.76,395,196,199,366,7.3
259,HAMPTON BAYS UFSD,91,6,21642.94,2006,1048,958,740,63.1
260,HANCOCK CSD,97,3,29004.88,308,159,149,279,9.4
261,HANNIBAL CSD,82,10,19515.27,1236,649,587,1187,4.0
262,HARBORFIELDS CSD,95,1,24499.74,2965,1510,1455,2133,28.1
263,HARPURSVILLE CSD,84,3,21205.12,641,365,276,611,4.7
264,HARRISON CSD,98,1,28893.27,3653,1820,1833,2366,35.2
265,HARRISVILLE CSD,91,9,25442.94,340,175,165,321,5.6
266,HARTFORD CSD,83,7,21509.80,410,230,180,384,6.3
267,HASTINGS-ON-HUDSON UFSD,96,1,27795.13,1656,840,816,1184,28.5
268,HAUPPAUGE UFSD,95,0,28953.45,3272,1725,1547,2361,27.8
269,HAVERSTRAW-STONY POINT CSD (NORTH RO,86,6,22215.24,7886,4031,3855,1776,77.5
270,HAWTHORNE-CEDAR KNOLLS UFSD,30,10,N/A,207,133,74,20,90.3
271,HEMPSTEAD UFSD,78,10,21489.70,6825,3624,3201,105,98.5
272,HENDRICK HUDSON CSD,94,1,28567.90,2267,1146,1121,1264,44.2
273,HERKIMER CSD,82,9,16820.51,1059,550,509,946,10.7
274,HERMON-DEKALB CSD,91,6,21992.93,391,201,190,376,3.8
275,HERRICKS UFSD,97,0,25834.33,4007,2067,1940,989,75.3
276,HEUVELTON CSD,75,8,21354.54,504,260,244,484,4.0
277,HEWLETT-WOODMERE UFSD,95,1,32708.80,2854,1511,1343,1780,37.6
278,HICKSVILLE UFSD,92,4,21799.60,5272,2747,2525,1360,74.2
279,HIGHLAND CSD,93,4,22380.21,1666,840,826,1162,30.3
280,HIGHLAND FALLS CSD,87,8,23505.03,962,474,488,559,41.9
281,HILTON CSD,94,1,15641.88,4295,2219,2076,3779,12.0
282,HINSDALE CSD,77,20,20616.41,387,175,212,354,8.5
283,HOLLAND CSD,95,2,18196.59,829,432,397,790,4.7
284,HOLLAND PATENT CSD,88,5,18430.98,1298,679,619,1284,1.1
285,HOLLEY CSD,94,2,19510.21,902,444,458,756,16.2
286,HOMER CSD,88,6,18818.88,1831,951,880,1708,6.7
287,HONEOYE CSD,94,0,23910.02,569,311,258,550,3.3
288,HONEOYE FALLS-LIMA CSD,94,2,17749.56,2122,1136,986,1950,8.1
289,HOOSIC VALLEY CSD,92,3,18681.68,931,486,445,892,4.2
290,HOOSICK FALLS CSD,90,3,18103.91,1064,548,516,978,8.1
292,HORNELL CITY SCHOOL DISTRICT,86,4,18297.48,1528,754,774,1302,14.8
293,HORSEHEADS CSD,92,3,16537.38,3842,1956,1886,3336,13.2
294,HUDSON CITY SCHOOL DISTRICT,80,7,24261.33,1617,810,807,647,60.0
295,HUDSON FALLS CSD,79,13,14076.68,2259,1137,1122,2029,10.2
296,HUNTER-TANNERSVILLE CSD,85,4,30553.49,331,150,181,268,19.0
297,HUNTINGTON UFSD,90,2,23794.52,4459,2307,2152,1549,65.3
298,HYDE PARK CSD,88,6,23435.59,3396,1735,1661,2017,40.6
300,INDIAN LAKE CSD,89,0,43135.85,100,45,55,93,7.0
301,INDIAN RIVER CSD,87,7,19354.30,3543,1772,1771,2329,34.3
302,IROQUOIS CSD,98,1,20509.11,2127,1078,1049,2013,5.4
303,IRVINGTON UFSD,92,0,29339.93,1776,936,840,1213,31.7
304,ISLAND PARK UFSD,—,—,32114.61,683,341,342,355,48.0
305,ISLAND TREES UFSD,95,2,24009.41,2238,1139,1099,1410,37.0
306,ISLIP UFSD,97,3,26255.56,2726,1347,1379,1553,43.0
307,ITHACA CITY SCHOOL DISTRICT,87,3,20297.74,5052,2578,2474,3243,35.8
308,JAMESTOWN CITY SCHOOL DISTRICT,74,14,15641.50,4479,2304,2175,2762,38.3
309,JAMESVILLE-DEWITT CSD,94,2,18413.64,2693,1404,1289,1977,26.6
310,JASPER-TROUPSBURG CSD,90,5,26007.34,401,216,185,392,2.2
311,JEFFERSON CSD,92,4,26743.10,196,100,96,187,4.6
312,JERICHO UFSD,96,0,33337.94,3159,1692,1467,933,70.5
313,JOHNSBURG CSD,89,11,27133.01,301,157,144,290,3.7
314,JOHNSON CITY CSD,90,5,18386.55,2347,1187,1160,1314,44.0
315,JOHNSTOWN CITY SCHOOL DISTRICT,88,3,15993.37,1501,800,701,1378,8.2
316,JORDAN-ELBRIDGE CSD,94,5,18668.50,1112,585,527,1052,5.4
317,KATONAH-LEWISBORO UFSD,94,1,32363.39,2915,1501,1414,2307,20.9
318,KEENE CSD,92,8,34485.18,157,75,82,144,8.3
319,KENDALL CSD,98,0,18527.39,684,356,328,615,10.1
320,KENMORE-TONAWANDA UFSD,88,5,19948.14,6648,3363,3285,4895,26.4
321,KINDERHOOK CSD,96,0,20073.39,1683,858,825,1422,15.5
322,KINGS PARK CSD,97,0,25791.61,2886,1440,1446,2425,16.0
323,KINGSTON CITY SCHOOL DISTRICT,87,8,22986.93,6308,3166,3142,3244,48.6
324,KIRYAS JOEL VILLAGE UFSD,0,43,107717.20,167,91,76,167,0.0
325,LA FARGEVILLE CSD,95,5,17047.91,495,246,249,462,6.7
326,LACKAWANNA CITY SCHOOL DISTRICT,82,14,17378.83,1790,937,853,1151,35.7
327,LAFAYETTE CSD,94,0,25122.89,792,401,391,473,40.3
328,LAKE GEORGE CSD,96,2,28540.50,722,360,362,663,8.2
329,LAKE PLACID CSD,88,2,26784.06,569,271,298,533,6.3
330,LAKE PLEASANT CSD,—,—,47512.33,65,33,32,64,1.5
331,LAKELAND CSD,92,1,24687.80,5510,2787,2723,3479,36.9
332,LANCASTER CSD,95,0,14140.10,5631,2874,2757,5146,8.6
333,LANSING CSD,90,1,21726.47,1187,602,585,952,19.8
334,LANSINGBURGH CSD,85,9,18039.45,2110,1134,976,1185,43.8
335,LAURENS CSD,84,8,23669.72,301,141,160,266,11.6
336,LAWRENCE UFSD,78,11,27720.33,2446,1289,1157,308,87.4
337,LE ROY CSD,90,5,16863.60,1176,583,593,1079,8.2
338,LETCHWORTH CSD,94,0,17015.69,893,464,429,857,4.0
339,LEVITTOWN UFSD,94,1,26952.80,7102,3635,3467,4514,36.4
340,LEWISTON-PORTER CSD,92,4,18690.08,1920,1004,916,1743,9.2
341,LIBERTY CSD,77,14,23182.34,1694,876,818,706,58.3
342,LINDENHURST UFSD,91,4,23636.09,5674,2882,2792,3696,34.9
343,LISBON CSD,92,0,20676.12,559,282,277,545,2.5
344,LITTLE FALLS CITY SCHOOL DISTRICT,79,17,19877.83,1073,546,527,966,10.0
345,LITTLE FLOWER UFSD,—,—,N/A,97,64,33,48,50.5
346,LIVERPOOL CSD,84,5,18169.54,6927,3478,3449,4941,28.7
347,LIVINGSTON MANOR CSD,74,10,30012.19,410,191,219,326,20.5
348,LIVONIA CSD,98,1,19693.89,1449,767,682,1363,5.9
349,LOCKPORT CITY SCHOOL DISTRICT,89,2,18128.21,4328,2206,2122,3050,29.5
350,LOCUST VALLEY CSD,97,0,37089.06,2012,1028,984,1473,26.8
351,LONG BEACH CITY SCHOOL DISTRICT,97,1,31355.75,3613,1879,1734,2098,41.9
352,LONG LAKE CSD,—,—,52830.45,59,32,27,56,5.1
353,LONGWOOD CSD,89,5,21996.25,9042,4626,4416,4107,54.6
354,LOWVILLE ACADEMY & CSD,92,5,16364.30,1283,653,630,1201,6.4
355,LYME CSD,95,5,19158.07,331,157,174,308,6.9
356,LYNBROOK UFSD,97,1,26396.92,2787,1422,1365,1871,32.9
357,LYNCOURT UFSD,—,—,20346.46,373,196,177,196,47.5
358,LYNDONVILLE CSD,96,4,20760.99,586,296,290,515,12.1
359,LYONS CSD,74,14,25724.35,833,434,399,621,25.5
360,MADISON CSD,94,3,18344.65,454,212,242,446,1.8
361,MADRID-WADDINGTON CSD,93,2,19452.88,655,331,324,632,3.5
362,MAHOPAC CSD,94,2,26934.25,3972,2029,1943,2840,28.5
363,MAINE-ENDWELL CSD,89,7,15937.75,2459,1226,1233,2154,12.4
364,MALONE CSD,87,4,20754.30,2199,1191,1008,2125,3.4
365,MALVERNE UFSD,92,3,28071.16,1724,910,814,311,82.0
366,MAMARONECK UFSD,94,2,22853.80,5596,2917,2679,3796,32.2
367,MANCHESTER-SHORTSVILLE CSD (RED JACK,82,4,18766.55,763,404,359,673,11.8
368,MANHASSET UFSD,98,0,25655.38,3163,1680,1483,2026,35.9
369,MARATHON CSD,98,0,21017.92,653,327,326,631,3.4
370,MARCELLUS CSD,92,3,19566.23,1505,802,703,1432,4.9
371,MARGARETVILLE CSD,88,8,25293.61,330,164,166,233,29.4
372,MARION CSD,86,4,22443.32,634,311,323,550,13.2
373,MARLBORO CSD,91,4,21764.90,1891,968,923,1188,37.2
374,MASSAPEQUA UFSD,98,1,25406.75,6713,3337,3376,6004,10.6
375,MASSENA CSD,84,7,16440.97,2475,1222,1253,2122,14.3
376,MATTITUCK-CUTCHOGUE UFSD,93,1,31170.72,1101,584,517,848,23.0
377,MAYFIELD CSD,90,4,18856.31,842,437,405,790,6.2
378,MCGRAW CSD,89,5,18417.53,527,256,271,503,4.6
379,MECHANICVILLE CITY SCHOOL DISTRICT,94,4,16937.42,1346,717,629,1195,11.2
380,MEDINA CSD,84,8,18543.05,1387,672,715,1074,22.6
381,MENANDS UFSD,—,—,17152.22,305,162,143,78,74.4
382,MERRICK UFSD,—,—,29454.36,1510,768,742,1300,13.9
383,MEXICO CSD,90,3,21774.73,1944,991,953,1833,5.7
384,MIDDLE COUNTRY CSD,91,4,22520.78,9050,4660,4390,5360,40.8
385,MIDDLEBURGH CSD,93,4,26103.54,654,316,338,633,3.2
386,MIDDLETOWN CITY SCHOOL DISTRICT,83,9,19264.71,7405,3739,3666,937,87.3
387,MILFORD CSD,88,4,24297.78,334,176,158,320,4.2
388,MILLBROOK CSD,96,0,26186.89,880,451,429,686,22.0
389,MILLER PLACE UFSD,97,1,24358.13,2490,1308,1182,2128,14.5
390,MINEOLA UFSD,94,2,28437.39,2790,1460,1330,1417,49.2
391,MINERVA CSD,40,20,41834.28,99,45,54,92,7.1
392,MINISINK VALLEY CSD,89,1,19866.22,3493,1779,1714,2588,25.9
394,MONROE-WOODBURY CSD,91,4,21906.32,6702,3384,3318,3186,52.5
395,MONTAUK UFSD,—,—,44925.84,286,146,140,182,36.4
396,MONTICELLO CSD,83,7,23954.20,2786,1424,1362,1165,58.2
397,MORAVIA CSD,84,9,18050.12,873,434,439,836,4.2
398,MORIAH CSD,89,6,20297.03,666,342,324,661,0.8
399,MORRIS CSD,77,0,23527.09,310,165,145,283,8.7
400,MORRISTOWN CSD,82,14,21795.55,322,167,155,308,4.3
401,MORRISVILLE-EATON CSD,88,8,20737.05,588,289,299,543,7.7
402,MOUNT MARKHAM CSD,86,8,19200.39,1038,527,511,997,3.9
403,MT MORRIS CSD,85,10,21224.05,515,264,251,359,30.3
404,MT PLEASANT CSD,96,0,27690.51,1902,993,909,1506,20.8
405,MT PLEASANT-BLYTHEDALE UFSD,0,0,N/A,124,68,56,37,70.2
406,MT PLEASANT-COTTAGE UFSD,9,27,N/A,214,103,111,23,89.3
407,MT SINAI UFSD,97,1,22321.61,2176,1131,1045,1802,17.2
408,MT VERNON SCHOOL DISTRICT,68,10,27660.55,7326,3755,3571,329,95.5
409,NANUET UFSD,94,1,25962.31,2218,1126,1092,1040,53.1
410,NAPLES CSD,87,4,17557.81,599,305,294,581,3.0
411,NEW HARTFORD CSD,97,1,17848.92,2553,1308,1245,2174,14.8
412,NEW HYDE PARK-GARDEN CITY PARK UFSD,—,—,19533.70,1719,882,837,402,76.6
413,NEW LEBANON CSD,92,5,9766.29,409,205,204,377,7.8
414,NEW PALTZ CSD,94,3,25094.98,2037,1036,1001,1534,24.7
415,NEW ROCHELLE CITY SCHOOL DISTRICT,80,3,22932.93,10286,5394,4892,2577,74.9
416,NEW SUFFOLK COMMON SCHOOL DISTRICT,—,—,36043.61,16,9,7,13,18.8
417,NEWARK CSD,88,9,20106.84,1983,1014,969,1394,29.7
418,NEWARK VALLEY CSD,88,5,18004.61,1075,547,528,1028,4.4
419,NEWBURGH CITY SCHOOL DISTRICT,78,10,21654.67,10913,5664,5249,1816,83.4
420,NEWCOMB CSD,100,0,59290.50,68,39,29,64,5.9
421,NEWFANE CSD,92,5,20242.16,1333,677,656,1236,7.3
422,NEWFIELD CSD,84,6,22438.23,728,355,373,586,19.5
423,NIAGARA FALLS CITY SCHOOL DISTRICT,64,24,16647.70,6572,3240,3332,2563,61.0
424,NIAGARA-WHEATFIELD CSD,90,5,17860.17,3411,1738,1673,2691,21.1
425,NISKAYUNA CSD,94,1,15876.85,4294,2239,2055,2952,31.3
426,NORTH BABYLON UFSD,93,4,25157.29,4539,2335,2204,1634,64.0
427,NORTH BELLMORE UFSD,—,—,22631.36,2020,1014,1006,1419,29.8
428,NORTH COLLINS CSD,92,4,21209.35,547,277,270,497,9.1
429,NORTH COLONIE CSD,93,3,16378.28,5887,2974,2913,3702,37.1
430,NORTH GREENBUSH COMMON SCHOOL DISTRICT (WILLIAMS),—,—,37967.85,13,5,8,11,15.4
431,NORTH MERRICK UFSD,—,—,25386.74,1188,610,578,868,26.9
432,NORTH ROSE-WOLCOTT CSD,87,6,21632.65,1114,535,579,966,13.3
433,NORTH SALEM CSD,96,2,34752.96,1046,523,523,775,25.9
434,NORTH SHORE CSD,96,0,36171.47,2567,1332,1235,1975,23.1
435,NORTH SYRACUSE CSD,87,5,15859.19,8175,4198,3977,6611,19.1
436,NORTH TONAWANDA CITY SCHOOL DISTRICT,86,7,17409.10,3184,1593,1591,2836,10.9
437,NORTH WARREN CSD,92,5,22431.62,493,269,224,449,8.9
438,NORTHEAST CSD,87,6,26227.20,626,333,293,435,30.5
439,NORTHEASTERN CLINTON CSD,81,9,22148.23,1235,622,613,1183,4.2
440,NORTHERN ADIRONDACK CSD,86,9,25473.35,785,418,367,777,1.0
441,NORTHPORT-EAST NORTHPORT UFSD,96,2,28285.29,5053,2646,2407,4092,19.0
442,NORTHVILLE CSD,94,3,20631.26,420,197,223,386,8.1
443,NORWICH CITY SCHOOL DISTRICT,86,4,18999.60,1672,848,824,1515,9.4
444,NORWOOD-NORFOLK CSD,90,5,20364.35,943,473,470,907,3.8
445,NY MILLS UFSD,87,4,22734.23,541,267,274,480,11.3
446,NYACK UFSD,91,5,24606.88,2866,1432,1434,1210,57.8
448,NYC GEOG DIST # 1 - MANHATTAN,68,8,N/A,10473,5481,4992,1928,81.6
449,NYC GEOG DIST # 2 - MANHATTAN,81,5,N/A,59568,28456,31112,15819,73.4
450,NYC GEOG DIST # 3 - MANHATTAN,81,3,N/A,21132,9599,11533,7076,66.5
451,NYC GEOG DIST # 4 - MANHATTAN,85,4,N/A,11510,5594,5916,574,95.0
452,NYC GEOG DIST # 5 - MANHATTAN,74,5,N/A,9332,4954,4378,597,93.6
453,NYC GEOG DIST # 6 - MANHATTAN,75,5,N/A,19124,9709,9415,1062,94.4
454,NYC GEOG DIST # 7 - BRONX,69,9,N/A,16318,8639,7679,244,98.5
455,NYC GEOG DIST # 8 - BRONX,66,13,N/A,24613,12660,11953,1382,94.4
456,NYC GEOG DIST # 9 - BRONX,74,9,N/A,29653,14989,14664,392,98.7
457,NYC GEOG DIST #10 - BRONX,80,7,N/A,49381,25187,24194,2927,94.1
458,NYC GEOG DIST #11 - BRONX,75,8,N/A,35438,18643,16795,3164,91.1
459,NYC GEOG DIST #12 - BRONX,63,12,N/A,19427,10007,9420,280,98.6
460,NYC GEOG DIST #13 - BROOKLYN,90,2,N/A,19994,10672,9322,3446,82.8
461,NYC GEOG DIST #14 - BROOKLYN,82,5,N/A,16583,8684,7899,2463,85.1
462,NYC GEOG DIST #15 - BROOKLYN,71,5,N/A,29846,14881,14965,8982,69.9
463,NYC GEOG DIST #16 - BROOKLYN,60,5,N/A,5425,2891,2534,148,97.3
464,NYC GEOG DIST #17 - BROOKLYN,74,6,N/A,19019,9361,9658,592,96.9
465,NYC GEOG DIST #18 - BROOKLYN,67,6,N/A,12417,6499,5918,420,96.6
466,NYC GEOG DIST #19 - BROOKLYN,79,6,N/A,19389,10230,9159,401,97.9
467,NYC GEOG DIST #20 - BROOKLYN,76,7,N/A,49535,25915,23620,12135,75.5
468,NYC GEOG DIST #21 - BROOKLYN,77,6,N/A,33868,17379,16489,10970,67.6
469,NYC GEOG DIST #22 - BROOKLYN,85,3,N/A,31931,16127,15804,10397,67.4
470,NYC GEOG DIST #23 - BROOKLYN,52,12,N/A,7714,4315,3399,103,98.7
471,NYC GEOG DIST #24 - QUEENS,80,5,N/A,54124,28429,25695,7141,86.8
472,NYC GEOG DIST #25 - QUEENS,76,5,N/A,35583,18163,17420,4026,88.7
473,NYC GEOG DIST #26 - QUEENS,92,3,N/A,30802,15826,14976,4705,84.7
474,NYC GEOG DIST #27 - QUEENS,76,10,N/A,40675,21347,19328,4072,90.0
475,NYC GEOG DIST #28 - QUEENS,84,5,N/A,38378,19482,18896,5989,84.4
476,NYC GEOG DIST #29 - QUEENS,77,6,N/A,23776,12395,11381,419,98.2
477,NYC GEOG DIST #30 - QUEENS,86,4,N/A,36697,18539,18158,6109,83.4
478,NYC GEOG DIST #31 - STATEN ISLAND,84,4,N/A,57787,29605,28182,25639,55.6
479,NYC GEOG DIST #32 - BROOKLYN,75,8,N/A,9850,5045,4805,233,97.6
481,NYC SPEC SCHOOLS - DIST 75,—,—,N/A,25358,18632,6726,3230,87.3
482,OAKFIELD-ALABAMA CSD,85,3,18394.15,772,379,393,720,6.7
483,OCEANSIDE UFSD,94,0,22535.44,5506,2852,2654,3889,29.4
484,ODESSA-MONTOUR CSD,93,4,18234.83,723,379,344,675,6.6
485,OGDENSBURG CITY SCHOOL DISTRICT,80,12,22365.24,1475,763,712,1446,2.0
486,OLEAN CITY SCHOOL DISTRICT,74,10,18698.78,1925,1008,917,1567,18.6
487,ONEIDA CITY SCHOOL DISTRICT,85,9,18768.60,1857,923,934,1641,11.6
488,ONEONTA CITY SCHOOL DISTRICT,84,7,17884.13,1734,885,849,1360,21.6
489,ONONDAGA CSD,90,6,19020.04,768,369,399,558,27.3
490,ONTEORA CSD,87,4,38615.96,1201,597,604,897,25.3
492,OPPENHEIM-EPHRATAH-ST. JOHNSVILLE CS,85,9,21080.92,689,335,354,668,3.0
493,ORCHARD PARK CSD,97,0,18291.68,4649,2318,2331,4304,7.4
494,ORISKANY CSD,92,2,20301.77,569,294,275,523,8.1
495,OSSINING UFSD,80,2,22422.60,4774,2464,2310,976,79.6
496,OSWEGO CITY SCHOOL DISTRICT,81,8,19998.39,3626,1870,1756,3254,10.3
497,OTEGO-UNADILLA CSD,87,5,21458.71,716,338,378,631,11.9
498,OTSELIC VALLEY CSD,94,3,27026.81,291,142,149,286,1.7
499,OWEGO-APALACHIN CSD,92,3,18179.70,1922,990,932,1825,5.0
500,OXFORD ACADEMY & CSD,95,2,22363.77,706,349,357,651,7.8
501,OYSTER BAY-EAST NORWICH CSD,95,3,31106.27,1528,776,752,964,36.9
502,OYSTERPONDS UFSD,—,—,39628.60,65,29,36,45,30.8
503,PALMYRA-MACEDON CSD,91,7,18477.61,1789,927,862,1657,7.4
504,PANAMA CSD,100,0,21679.03,436,223,213,412,5.5
505,PARISHVILLE-HOPKINTON CSD,97,0,25102.89,365,187,178,361,1.1
506,PATCHOGUE-MEDFORD UFSD,86,4,22688.05,7349,3796,3553,3232,56.0
507,PAVILION CSD,83,11,21512.28,638,332,306,605,5.2
508,PAWLING CSD,93,0,28302.88,1114,571,543,786,29.4
509,PEARL RIVER UFSD,96,1,23852.00,2361,1207,1154,1816,23.1
510,PEEKSKILL CITY SCHOOL DISTRICT,80,8,22977.07,3352,1791,1561,230,93.1
511,PELHAM UFSD,98,0,22511.94,2913,1515,1398,1901,34.7
512,PEMBROKE CSD,92,2,21102.75,910,435,475,851,6.5
513,PENFIELD CSD,97,1,16744.56,4587,2333,2254,3780,17.6
514,PENN YAN CSD,87,8,22166.64,1312,640,672,1213,7.5
515,PERRY CSD,92,3,18437.89,772,389,383,696,9.8
516,PERU CSD,89,7,21325.68,1822,948,874,1716,5.8
517,PHELPS-CLIFTON SPRINGS CSD,85,11,18223.93,1549,809,740,1386,10.5
518,PHOENIX CSD,87,8,21337.44,1644,839,805,1558,5.2
519,PINE BUSH CSD,91,4,20058.09,4925,2563,2362,3413,30.7
520,PINE PLAINS CSD,89,5,28458.63,855,425,430,670,21.6
521,PINE VALLEY CSD (SOUTH DAYTON),66,15,24415.35,485,243,242,438,9.7
522,PITTSFORD CSD,98,0,19861.85,5588,2876,2712,4083,26.9
523,PLAINEDGE UFSD,95,0,26342.58,2823,1454,1369,2434,13.8
524,PLAINVIEW-OLD BETHPAGE CSD,96,0,26869.50,4955,2547,2408,3284,33.7
525,PLATTSBURGH CITY SCHOOL DISTRICT,84,8,21291.56,1800,935,865,1544,14.2
526,PLEASANTVILLE UFSD,93,1,25303.29,1695,877,818,1283,24.3
527,POCANTICO HILLS CSD,—,—,53858.30,285,137,148,110,61.4
528,POLAND CSD,93,7,23870.17,487,242,245,453,7.0
529,PORT BYRON CSD,86,4,23478.26,728,356,372,688,5.5
530,PORT CHESTER-RYE UFSD,82,5,17876.84,4775,2502,2273,603,87.4
531,PORT JEFFERSON UFSD,96,1,35628.81,1022,526,496,778,23.9
532,PORT JERVIS CITY SCHOOL DISTRICT,86,6,25319.90,2444,1245,1199,1609,34.2
533,PORT WASHINGTON UFSD,93,2,25331.03,5364,2749,2615,3377,37.0
534,PORTVILLE CSD,95,3,14307.29,986,469,517,921,6.6
535,POTSDAM CSD,95,3,20234.62,1234,667,567,1124,8.9
536,POUGHKEEPSIE CITY SCHOOL DISTRICT,60,19,21427.37,4154,2184,1970,260,93.7
537,PRATTSBURGH CSD,84,4,18240.82,360,179,181,331,8.1
538,PULASKI CSD,87,4,20825.86,924,465,459,889,3.8
539,PUTNAM CSD,—,—,23009.37,28,19,9,28,0.0
540,PUTNAM VALLEY CSD,97,1,26817.67,1598,808,790,1095,31.5
542,QUEENSBURY UFSD,90,3,16548.22,3135,1622,1513,2915,7.0
543,QUOGUE UFSD,—,—,69868.40,77,38,39,59,23.4
544,RANDOLPH ACAD UFSD,—,—,N/A,164,118,46,103,37.2
545,RANDOLPH CSD,99,0,18397.12,846,421,425,753,11.0
546,RAVENA-COEYMANS-SELKIRK CSD,88,6,18848.63,1768,895,873,1431,19.1
547,RED CREEK CSD,88,10,21345.38,783,424,359,744,5.0
548,RED HOOK CSD,91,4,24227.11,1766,918,848,1474,16.5
549,REMSEN CSD,87,0,26257.19,405,216,189,391,3.5
550,REMSENBURG-SPEONK UFSD,—,—,58547.76,132,66,66,96,27.3
551,RENSSELAER CITY SCHOOL DISTRICT,84,5,17978.00,1028,524,504,570,44.6
552,RHINEBECK CSD,93,1,30026.67,944,466,478,784,16.9
553,RICHFIELD SPRINGS CSD,92,8,24034.39,402,223,179,380,5.5
555,RIPLEY CSD,—,—,33327.70,123,61,62,117,4.9
556,RIVERHEAD CSD,76,13,18810.89,5829,3028,2801,1925,67.0
557,ROCHESTER CITY SCHOOL DISTRICT,68,13,19885.50,25017,12904,12113,2394,90.4
558,ROCKVILLE CENTRE UFSD,98,0,29490.95,3579,1855,1724,2631,26.5
559,ROCKY POINT UFSD,95,4,24991.00,2905,1441,1464,2264,22.1
560,ROME CITY SCHOOL DISTRICT,82,8,17823.87,5320,2736,2584,4204,21.0
561,ROMULUS CSD,82,6,20890.39,434,210,224,386,11.1
562,RONDOUT VALLEY CSD,88,8,28695.99,1869,978,891,1572,15.9
563,ROOSEVELT UFSD,75,16,20300.43,3346,1780,1566,2,99.9
564,ROSCOE CSD,89,0,30693.78,220,120,100,190,13.6
565,ROSLYN UFSD,99,1,29181.70,3195,1622,1573,2165,32.2
566,ROTTERDAM-MOHONASEN CSD,91,3,15118.77,2798,1418,1380,2130,23.9
567,ROXBURY CSD,86,0,34739.37,239,112,127,229,4.2
568,ROYALTON-HARTLAND CSD,92,6,16056.73,1206,587,619,1101,8.7
569,RUSH-HENRIETTA CSD,92,3,19635.20,5387,2725,2662,3091,42.6
570,RYE CITY SCHOOL DISTRICT,96,0,25422.18,3234,1670,1564,2567,20.6
571,RYE NECK UFSD,93,1,22836.77,1572,809,763,983,37.5
572,SACHEM CSD,94,2,20861.50,12351,6266,6085,8650,30.0
573,SACKETS HARBOR CSD,90,5,18003.63,418,204,214,373,10.8
574,SAG HARBOR UFSD,89,3,38192.07,919,461,458,664,27.7
575,SAGAPONACK COMMON SCHOOL DISTRICT,—,—,55333.31,16,9,7,15,6.2
576,SALAMANCA CITY SCHOOL DISTRICT,79,3,24617.42,1213,628,585,601,50.5
577,SALEM CSD,78,12,19489.37,524,286,238,496,5.3
578,SALMON RIVER CSD,85,6,26274.61,1389,703,686,449,67.7
579,SANDY CREEK CSD,90,3,25117.81,742,396,346,708,4.6
580,SARANAC CSD,90,7,22036.63,1395,714,681,1345,3.6
581,SARANAC LAKE CSD,93,4,24587.99,1150,602,548,1118,2.8
582,SARATOGA SPRINGS CITY SCHOOL DISTRICT,92,4,17059.93,6248,3164,3084,5511,11.8
583,SAUGERTIES CSD,84,10,21994.66,2449,1205,1244,1846,24.6
584,SAUQUOIT VALLEY CSD,93,3,17140.41,943,463,480,871,7.6
585,SAYVILLE UFSD,97,0,27033.14,2822,1445,1377,2458,12.9
586,SCARSDALE UFSD,98,1,28842.09,4749,2450,2299,3019,36.4
587,SCHALMONT CSD,90,4,18953.56,1799,940,859,1535,14.7
588,SCHENECTADY CITY SCHOOL DISTRICT,74,11,18266.00,9243,4779,4464,1890,79.6
589,SCHENEVUS CSD,81,9,21163.27,330,177,153,311,5.8
590,SCHODACK CSD,97,0,21104.26,900,465,435,829,7.9
591,SCHOHARIE CSD,89,4,20304.39,889,469,420,840,5.5
592,SCHROON LAKE CSD,100,0,25128.01,259,136,123,255,1.5
593,SCHUYLERVILLE CSD,96,2,19497.47,1517,770,747,1442,4.9
594,SCIO CSD,81,16,25594.63,302,165,137,293,3.0
595,SCOTIA-GLENVILLE CSD,88,6,19185.24,2371,1257,1114,2127,10.3
596,SEAFORD UFSD,95,2,26115.27,2247,1146,1101,1968,12.4
597,SENECA FALLS CSD,87,6,16786.23,1198,618,580,984,17.9
598,SEWANHAKA CENTRAL HS DISTRICT,95,1,20338.62,8140,4213,3927,2578,68.3
599,SHARON SPRINGS CSD,94,6,38377.69,226,109,117,210,7.1
600,SHELTER ISLAND UFSD,96,4,48559.74,192,99,93,127,33.9
601,SHENENDEHOWA CSD,92,3,15279.98,9535,4806,4729,7120,25.3
602,SHERBURNE-EARLVILLE CSD,86,3,20802.82,1286,670,616,1236,3.9
603,SHERMAN CSD,91,3,20545.12,402,217,185,386,4.0
604,SHERRILL CITY SCHOOL DISTRICT,95,3,16933.80,1805,951,854,1711,5.2
605,SHOREHAM-WADING RIVER CSD,94,1,26463.85,2039,1042,997,1768,13.3
606,SIDNEY CSD,93,4,19569.51,1057,550,507,916,13.3
607,SILVER CREEK CSD,89,4,19547.02,1022,495,527,728,28.8
608,SKANEATELES CSD,94,2,19456.71,1283,682,601,1206,6.0
609,SMITHTOWN CSD,95,0,24979.97,8398,4222,4176,6751,19.6
610,SODUS CSD,86,4,20747.89,965,512,453,573,40.6
611,SOLVAY UFSD,89,1,18811.28,1380,695,685,986,28.6
612,SOMERS CSD,94,0,27456.96,2862,1465,1397,2378,16.9
613,SOUTH COLONIE CSD,94,2,18621.48,4671,2335,2336,3012,35.5
614,SOUTH COUNTRY CSD,83,8,26730.96,4065,2111,1954,1498,63.1
615,SOUTH GLENS FALLS CSD,88,5,15609.87,2916,1522,1394,2667,8.5
616,SOUTH HUNTINGTON UFSD,89,3,23839.17,5849,3047,2802,2214,62.1
617,SOUTH JEFFERSON CSD,88,3,15009.88,1814,904,910,1706,6.0
618,SOUTH KORTRIGHT CSD,94,0,20685.26,330,170,160,306,7.3
619,SOUTH LEWIS CSD,85,6,21091.90,976,493,483,926,5.1
620,SOUTH ORANGETOWN CSD,93,2,27002.95,2910,1436,1474,1967,32.4
621,SOUTH SENECA CSD,90,7,28768.85,618,291,327,587,5.0
622,SOUTHAMPTON UFSD,89,2,35375.27,1471,777,694,653,55.6
623,SOUTHERN CAYUGA CSD,86,9,20456.50,664,331,333,548,17.5
624,SOUTHOLD UFSD,87,9,34388.43,769,417,352,479,37.7
625,SOUTHWESTERN CSD AT JAMESTOWN,92,4,16269.54,1300,703,597,1142,12.2
626,SPACKENKILL UFSD,90,4,28094.81,1448,751,697,841,41.9
627,SPENCER-VAN ETTEN CSD,81,8,21091.38,831,420,411,789,5.1
628,SPENCERPORT CSD,91,4,18387.91,3618,1876,1742,2879,20.4
629,SPRINGS UFSD,—,—,25059.64,668,365,303,256,61.7
630,SPRINGVILLE-GRIFFITH INST CSD,96,1,19368.61,1647,843,804,1554,5.6
632,ST REGIS FALLS CSD,95,0,27120.59,249,125,124,229,8.0
633,STAMFORD CSD,71,10,25978.35,263,117,146,244,7.2
634,STARPOINT CSD,93,3,14872.59,2911,1468,1443,2714,6.8
635,STILLWATER CSD,84,11,19288.45,1014,509,505,956,5.7
636,STOCKBRIDGE VALLEY CSD,90,7,20271.97,410,205,205,380,7.3
637,SUFFERN CSD,92,4,27125.39,4012,2024,1988,2040,49.2
638,SULLIVAN WEST CSD,90,8,26133.65,1014,532,482,861,15.1
639,SUSQUEHANNA VALLEY CSD,87,7,20962.12,1426,748,678,1277,10.4
640,SWEET HOME CSD,94,3,19798.51,3261,1742,1519,2032,37.7
641,SYOSSET CSD,99,0,30765.31,6580,3414,3166,3430,47.9
642,SYRACUSE CITY SCHOOL DISTRICT,71,11,19030.39,19011,9916,9095,4170,78.1
643,TACONIC HILLS CSD,75,12,24336.16,1205,612,593,961,20.2
644,THOUSAND ISLANDS CSD,95,3,19397.93,867,425,442,794,8.4
645,THREE VILLAGE CSD,96,1,31655.63,5809,2922,2887,4476,22.9
646,TICONDEROGA CSD,91,5,23812.19,682,361,321,669,1.9
647,TIOGA CSD,91,4,15563.69,886,446,440,860,2.9
648,TONAWANDA CITY SCHOOL DISTRICT,93,3,16138.80,1729,880,849,1505,13.0
649,TOWN OF WEBB UFSD,100,0,26872.80,259,136,123,250,3.5
650,TRI-VALLEY CSD,75,19,27786.88,930,495,435,754,18.9
651,TROY CITY SCHOOL DISTRICT,88,7,19801.65,3842,1927,1915,1527,60.3
652,TRUMANSBURG CSD,91,0,20889.47,999,514,485,853,14.6
653,TUCKAHOE COMMON SCHOOL DISTRICT,—,—,51082.72,253,121,132,65,74.3
654,TUCKAHOE UFSD,99,0,25010.58,1184,615,569,786,33.6
655,TULLY CSD,81,3,19646.46,737,391,346,689,6.5
656,TUPPER LAKE CSD,89,2,20549.25,712,365,347,669,6.0
657,TUXEDO UFSD,100,0,45079.45,222,111,111,143,35.6
658,UFSD-TARRYTOWNS,90,5,25569.87,2682,1355,1327,828,69.1
659,UNADILLA VALLEY CSD,84,3,22294.87,758,368,390,724,4.5
660,UNION SPRINGS CSD,94,0,18831.95,791,431,360,709,10.4
661,UNION-ENDICOTT CSD,88,5,18861.64,3569,1795,1774,2422,32.1
662,UNIONDALE UFSD,78,11,24253.37,6748,3438,3310,103,98.5
663,UTICA CITY SCHOOL DISTRICT,73,13,15176.09,9738,4917,4821,2838,70.9
664,VALHALLA UFSD,93,1,30131.68,1387,706,681,749,46.0
665,VALLEY CSD (MONTGOMERY),92,4,21709.36,4131,2073,2058,2499,39.5
666,VALLEY STREAM 13 UFSD,—,—,21831.30,1963,1049,914,464,76.4
667,VALLEY STREAM 24 UFSD,—,—,23989.49,1097,560,537,195,82.2
668,VALLEY STREAM 30 UFSD,—,—,21680.41,1464,745,719,69,95.3
669,VALLEY STREAM CENTRAL HS DISTRICT,93,2,22335.67,4542,2315,2227,746,83.6
670,VAN HORNESVILLE-OWEN D YOUNG CSD,91,5,23917.91,181,85,96,175,3.3
671,VESTAL CSD,93,2,18422.74,3291,1695,1596,2542,22.8
672,VICTOR CSD,95,2,13662.02,4272,2140,2132,3530,17.4
673,VOORHEESVILLE CSD,96,2,17552.50,1180,581,599,1062,10.0
674,WAINSCOTT COMMON SCHOOL DISTRICT,—,—,28103.79,29,14,15,11,62.1
675,WALLKILL CSD,90,3,21761.44,2831,1482,1349,1847,34.8
676,WALTON CSD,86,11,20436.21,866,433,433,828,4.4
677,WANTAGH UFSD,98,0,24819.00,2770,1397,1373,2357,14.9
678,WAPPINGERS CSD,94,3,19359.75,10645,5511,5134,7327,31.2
679,WARRENSBURG CSD,85,8,23590.05,662,352,310,620,6.3
680,WARSAW CSD,92,7,18447.56,820,390,430,751,8.4
681,WARWICK VALLEY CSD,95,1,18948.67,3569,1818,1751,2669,25.2
682,WASHINGTONVILLE CSD,94,2,20640.42,3801,1904,1897,2268,40.3
683,WATERFORD-HALFMOON UFSD,90,5,23921.21,752,385,367,677,10.0
684,WATERLOO CSD,90,4,20639.44,1538,784,754,1345,12.5
685,WATERTOWN CITY SCHOOL DISTRICT,77,14,14799.55,3972,2061,1911,2747,30.8
686,WATERVILLE CSD,93,0,19097.10,741,395,346,722,2.6
687,WATERVLIET CITY SCHOOL DISTRICT,88,7,13712.89,1296,697,599,592,54.3
688,WATKINS GLEN CSD,95,1,21000.88,983,508,475,898,8.6
689,WAVERLY CSD,90,8,17881.28,1442,713,729,1371,4.9
690,WAYLAND-COHOCTON CSD,94,4,19889.88,1247,621,626,1202,3.6
691,WAYNE CSD,92,4,18290.82,2127,1095,1032,1981,6.9
692,WEBSTER CSD,95,1,17463.98,8151,4194,3957,6741,17.3
693,WEEDSPORT CSD,96,2,21378.37,725,365,360,667,8.0
694,WELLS CSD,89,6,32101.51,135,83,52,131,3.0
695,WELLSVILLE CSD,82,6,19328.04,1077,527,550,1017,5.6
696,WEST BABYLON UFSD,92,4,24688.51,3705,1867,1838,2154,41.9
697,WEST CANADA VALLEY CSD,96,2,21996.67,650,306,344,624,4.0
698,WEST GENESEE CSD,95,0,16351.60,4483,2312,2171,3852,14.1
699,WEST HEMPSTEAD UFSD,89,6,27633.69,1759,930,829,401,77.2
700,WEST IRONDEQUOIT CSD,93,2,17041.73,3620,1885,1735,2541,29.8
701,WEST ISLIP UFSD,98,0,24902.21,4006,2097,1909,3315,17.2
703,WEST SENECA CSD,91,4,16393.80,6214,3178,3036,5279,15.0
704,WEST VALLEY CSD,79,14,36386.31,190,98,92,181,4.7
705,WESTBURY UFSD,84,11,24100.60,4979,2569,2410,98,98.0
706,WESTFIELD CSD,80,4,22096.84,632,308,324,573,9.3
707,WESTHAMPTON BEACH UFSD,93,3,25836.22,1820,950,870,1170,35.7
708,WESTHILL CSD,96,3,17204.54,1778,841,937,1486,16.4
709,WESTMORELAND CSD,95,0,20977.82,853,421,432,810,5.0
711,WHEATLAND-CHILI CSD,88,3,24615.30,636,305,331,444,30.2
712,WHEELERVILLE UFSD,—,—,25960.01,117,61,56,113,3.4
713,WHITE PLAINS CITY SCHOOL DISTRICT,91,3,27671.34,7069,3564,3505,1549,78.1
714,WHITEHALL CSD,76,16,20970.97,703,346,357,683,2.8
715,WHITESBORO CSD,94,4,17518.67,3143,1602,1541,2824,10.1
716,WHITESVILLE CSD,93,0,25735.40,179,90,89,174,2.8
717,WHITNEY POINT CSD,78,6,20246.09,1329,672,657,1289,3.0
718,WILLIAM FLOYD UFSD,89,4,20200.92,8837,4514,4323,3545,59.9
719,WILLIAMSON CSD,94,1,18664.46,984,512,472,798,18.9
720,WILLIAMSVILLE CSD,95,2,16128.34,9913,5014,4899,7248,26.9
721,WILLSBORO CSD,80,5,29014.65,229,108,121,209,8.7
722,WILSON CSD,91,8,19651.21,1042,545,497,948,9.0
723,WINDHAM-ASHLAND-JEWETT CSD,95,5,30935.23,291,155,136,246,15.5
724,WINDSOR CSD,92,4,20400.27,1528,778,750,1391,9.0
725,WORCESTER CSD,100,0,22629.71,320,149,171,312,2.5
726,WYANDANCH UFSD,56,17,21454.95,2700,1381,1319,26,99.0
727,WYNANTSKILL UFSD,—,—,17164.28,376,187,189,334,11.2
728,WYOMING CSD,—,—,28167.77,128,70,58,125,2.3
729,YONKERS CITY SCHOOL DISTRICT,91,3,18820.45,24633,12524,12109,3818,84.5
730,YORK CSD,97,2,19869.81,688,377,311,651,5.4
731,YORKSHIRE-PIONEER CSD,89,6,17445.73,2307,1196,1111,2192,5.0
732,YORKTOWN CSD,97,1,24424.21,3401,1775,1626,2456,27.8
